111111111111111
100000C000E0001
101110111110101
1P000000C000001
111101111111101
100000000000001
111110111110001
100000000000001
1C00001110C0001
111111111111111
