11111111111111111111
1C000000000000000C01
10110101010101010101
10000100000000000001
1P0000000C0000E00001
11111111111011111111
10000000000000000001
10111010111111101001
10000C00000000000001
11111111111111111111
