111111111111111111111
100000000000000000001
101110111111101111101
1P00000C00000000000C1
101111111111111110101
100000000000000000001
111110111111111110101
100000000000000000001
1C000000000E0000000C1
111111111111111111111
