1111111111111111111111111
1000000000000000000000001
1011010111011010101010101
1P000000000000000000C0001
111111111111C111111111111
1000000000000000000000001
1011101111111011101010101
1000000000000000000000001
1C0000000000000000E0000C1
1111111111111111111111111
